100	3	1
101	2	1
102	4	1
103	1	1
104	4	1
105	3	1
106	2	1
107	4	1
108	4	1
109	3	1
110	3	1
201	3	1
202	3	1
203	3	1
204	4	1
205	2	1
206	4	1
207	3	1
208	3	1
209	2	1
210	4	1